F	F	F	F	F	F	F	F	F	F	F	F	F	F	F	M	M	M	M	M	M	M	M	M	M	M	M	M	M	M	M	M	M	M	M	M	M	M	M	M	M	M				
F	G	G	F	G	F	G	F	G	G	G	G	G	G	G	M	M	M	M	M	M	M	A	A	A	A	A	M	M	M	M	M	M	A	A	A	A	M	M	M	M	M				
F	G	G	F	G	G	G	F	G	F	G	G	G	G	G	G	M	M	M	M	M	A	A	A	A	A	A	A	M	M	M	M	A	A	A	A	A	A	M	M	M	M				
F	G	F	F	G	F	G	F	G	F	G	G	F	G	G	G	G	M	A	A	A	A	A	A	A	A	A	A	A	A	A	A	A	A	A	A	A	A	A	A	M	M				
F	G	G	G	G	F	G	F	G	F	G	G	F	G	G	G	G	M	A	M	M	A	A	A	A	A	A	A	M	M	M	M	A	A	A	A	A	A	M	M	M	M				
F	G	F	F	G	F	G	F	G	F	G	F	F	F	G	G	G	M	A	M	M	M	A	A	A	A	A	M	M	M	M	R	M	A	A	A	A	M	R	M	M	M				
F	G	F	F	G	F	G	G	G	F	G	G	G	G	G	G	G	M	A	M	M	M	M	M	M	M	M	M	M	M	M	R	M	M	M	M	M	M	R	M	M	M				
F	G	F	F	F	F	G	F	F	F	G	G	G	G	G	G	G	M	A	M	M	M	M	M	M	M	M	M	M	M	M	R	M	M	M	M	M	M	R	M	G	M				
F	G	G	F	G	G	G	G	G	F	G	G	R	G	G	G	G	M	A	A	A	A	A	A	A	A	A	A	A	M	M	R	M	M	M	M	M	M	R	M	G	M				
F	F	F	F	G	F	F	F	G	G	G	R	R	R	G	G	G	M	A	M	M	M	M	M	A	M	M	M	A	M	M	R	M	M	M	M	M	M	R	M	G	M				
F	G	G	F	G	G	G	G	G	G	R	R	R	R	R	G	G	M	M	M	F	F	F	M	M	M	F	F	F	F	F	R	G	G	M	M	G	G	R	G	G	M				
F	G	G	F	G	G	F	G	G	G	G	R	R	R	G	G	G	G	G	G	G	G	G	G	G	G	G	G	G	G	R	R	R	R	R	R	R	R	R	G	G	M				
F	G	G	F	G	G	F	G	G	G	G	G	R	G	G	G	G	G	G	G	G	G	G	G	G	G	G	G	G	G	R	G	G	F	G	G	G	G	G	F	G	M				
F	G	G	F	G	G	F	G	G	G	G	G	G	G	G	G	G	F	F	F	G	G	G	F	F	F	F	G	G	G	R	G	G	G	G	G	G	F	G	F	G	M				
F	G	G	G	G	G	G	G	G	G	G	G	G	G	G	G	G	G	G	G	G	G	G	G	G	G	G	G	G	G	R	G	F	G	F	G	F	F	G	F	G	M				
F	G	F	F	F	F	F	G	F	F	F	G	G	G	G	G	G	G	G	G	G	G	G	G	G	G	G	G	G	G	R	G	G	G	G	G	G	G	G	G	G	M				
F	G	G	G	G	G	G	G	G	G	G	G	G	G	G	G	G	R	R	R	R	R	R	R	R	R	R	G	G	G	G	G	M	M	M	M	M	M	M	M	M	M				
F	G	G	G	G	G	G	G	G	R	G	G	F	G	F	G	G	R	G	G	G	G	G	G	G	G	R	G	G	G	R	G	M	A	A	A	A	A	A	A	A	M				
F	G	F	G	G	F	G	G	G	R	G	G	G	G	G	G	G	R	G	F	G	G	G	G	F	G	R	R	R	R	R	G	M	A	M	A	A	M	A	A	A	M				
F	G	F	G	G	F	G	G	G	R	G	G	F	G	F	G	G	G	G	G	G	G	G	G	G	G	R	G	G	G	G	G	M	A	M	M	M	M	M	M	M	M				
F	G	F	G	G	F	G	G	G	R	G	G	G	G	G	G	G	R	G	G	G	G	G	G	G	G	R	G	G	G	M	G	M	A	A	A	A	A	A	A	A	M				
F	G	F	G	G	F	G	G	G	R	G	F	F	F	F	G	G	R	G	F	G	G	G	G	F	G	G	G	G	G	M	G	M	A	M	M	M	M	A	M	M	M				
F	G	G	G	G	G	G	G	G	R	G	G	G	G	G	G	G	R	G	G	G	G	G	G	G	G	R	G	M	G	M	G	M	A	A	A	A	A	A	A	A	M				
F	G	G	G	G	G	G	G	G	G	G	F	F	F	F	G	G	R	R	R	R	G	G	R	R	R	R	G	M	G	M	G	M	M	M	A	A	M	M	M	M	M				
F	F	F	F	F	F	F	G	G	F	F	F	F	F	F	F	F	F	G	G	G	G	G	G	G	G	R	G	M	G	M	G	G	G	G	G	G	G	G	G	G	M				
F	F	F	F	F	F	G	G	F	F	F	F	F	G	F	F	F	F	F	G	F	F	F	G	G	G	R	G	M	G	G	G	G	G	G	G	G	G	G	G	G	M				
F	G	F	G	F	G	G	G	F	F	F	F	G	G	G	F	F	F	F	G	F	F	F	G	G	G	R	G	M	G	G	G	M	M	M	M	M	M	M	M	M	M				
M	G	G	G	F	G	G	G	F	F	F	G	G	G	G	G	F	F	F	G	G	G	G	G	G	G	R	G	G	G	G	G	G	G	G	M	G	G	G	G	G	M				
M	G	G	G	F	G	G	G	F	F	F	F	G	G	G	F	F	F	F	G	F	G	G	G	G	G	R	G	G	G	G	G	G	G	G	M	G	G	G	G	G	M				
M	G	G	G	G	G	G	G	G	F	F	F	F	G	F	F	F	F	G	G	F	G	G	G	G	G	R	R	R	G	R	R	R	R	G	M	G	M	M	M	M	M				
M	G	G	G	G	G	G	G	G	G	G	G	G	G	G	G	G	G	G	G	G	G	G	G	G	G	G	G	G	G	G	G	G	R	G	G	G	G	G	G	G	M				
M	M	M	M	M	M	M	M	M	G	G	G	G	M	M	M	M	M	M	M	G	G	M	M	M	M	G	G	G	G	G	G	G	R	M	M	M	M	M	M	G	M				
M	A	A	A	A	A	A	A	M	G	G	G	G	M	G	G	G	G	G	G	G	G	G	G	G	M	G	G	G	G	G	G	G	R	M	M	M	M	M	M	M	M				
M	A	M	M	A	A	A	A	M	G	G	G	G	M	G	G	G	G	G	G	G	G	F	G	G	M	G	G	R	R	R	R	R	R	R	R	M	M	R	R	R	M				
M	A	M	M	A	A	A	A	M	G	G	G	G	M	G	F	G	G	R	R	G	G	F	G	G	M	G	G	R	R	M	R	R	R	R	R	M	M	R	R	R	M				
M	A	A	A	A	A	A	A	M	G	G	M	G	M	G	G	G	G	R	R	G	G	F	G	G	M	G	G	R	R	R	R	M	M	R	R	M	M	R	R	R	M				
M	A	A	A	A	A	A	A	M	G	G	M	G	G	G	G	G	G	G	G	G	G	G	G	G	M	G	G	R	R	R	R	M	M	R	R	M	M	R	R	R	M				
M	A	A	A	A	A	A	M	M	M	M	M	G	G	F	G	G	G	G	G	F	F	F	G	G	M	G	G	R	R	R	R	R	R	R	R	M	M	R	R	R	M				
M	A	A	A	A	A	A	A	A	M	M	M	G	G	F	G	R	R	R	G	G	F	G	G	G	M	G	G	R	R	R	R	R	R	R	R	M	M	R	R	R	M				
M	A	A	A	A	A	A	A	A	M	M	M	G	G	F	G	G	G	G	G	G	F	G	G	G	M	G	G	R	R	R	R	R	R	R	R	R	R	R	R	R	M				
M	A	A	A	A	A	A	A	A	A	G	G	G	G	G	G	G	G	G	G	G	G	G	G	G	M	M	M	R	R	R	R	R	R	R	R	R	R	R	R	R	M				
M	M	M	M	M	M	M	M	M	M	M	M	M	M	M	M	M	M	M	M	M	M	M	M	M	M	M	M	M	M	M	M	M	M	M	M	M	M	M	M	M	M				
